
SO ./texture/blue32.xpm
R 400 400
NO ./texture/brick32.xpm
S ./texture/barrel32.xpm
F 220,100,0
EA ./texture/wood32.xpm
C 225,30,0
WE ./texture/grey32.xpm
                  111
                 10001
                1002001
               111101111
              11110001111
             1111000001111
            111100000001111
           11110000000001111
          1111000000000001111
         1111000000S0000001111
    1111111111111111111111111111111

