R 2000 2000
NO ./texture/brick.xpm
SO ./texture/blue.xpm
WE ./texture/grey.xpm
EA ./texture/wood.xpm

S ./texture/barrel.xpm
F 0 0   0
C 255 255    255


        1111111111111111111111111
        1200000002112000000000021
        1011000001110000002000001
        1001000000000000000000001
111111111011000001112000000000021
120000000011000001110111111111111
11110111111111011120000210001
11110111111111011101010010001
11000000110101011100000010001
12002000000000001100000010001
10000000000000001101010010001
11000001110101011111N1111000111
11112111 1110101 101111010021
11111111 1111111 111111111111
