     R 600 300
           
                   NO ./texture/wood.xpm
          
   SO ./texture/grey.xpm
           
          WE ./texture/brick.xpm
           
                 EA ./texture/blue.xpm

 S ./texture/chalice.xpm
           
F 0,255,0

                   C 0,0,255


        1111111111111111111111111
        1000000011110000000000001
        101100001  10000002000001
        1001000011110000000000001
111111111011000001110000000000001
100000000011000001110111111111111
11110111111111010000000010001
11110111111111011111010010001
1100000011010101   1000000101
10002000000000011111000010001
10000000000000001101010010001
11000001110101011111011110N0111
11110111 1110101 101111010001
11111111 1111111 111111111111
