SO ./texture/blue.xpm
R 499 20000
NO ./texture/brick.xpm
S ./texture/barrel.xpm
F 30,30,30
EA ./texture/wood.xpm
C 60,60,60
WE ./texture/grey.xpm
                  111
                 10001
                1002001
               111101111
              11110001111
             1111000001111                               111
            111100000001111                             10001
           11110000000001111                           1000001
          1111000000000001111                         100000001
         1111000000000000011111111111111111111111111110000000001
        11110000000N000000000000000000000000000000000000000000001
       11110000000000000000011111111111111111111111110000000000001
      111100000000000000000001111                 10000000000000001
     11110000000000000000000001111               1000000000000000001
    1111111111111111111111111111111             111111111111111111111
   111111111111111111111111111111111
