R 1920 1080
NO ./texture/brick.xpm
SO ./texture/blue.xpm
WE ./texture/grey.xpm
EA ./texture/wood.xpm

S ./texture/chalice.xpm
F 0,0,0
C 255,255,255

                  111
                 10001
                1002001
               111101111
              11110001111
             1111000001111                              11111
            111100000001111                            1102011
           11110000000001111                          110000011
          1111000000000001111                        11000000011
         11110000000000000111111111111111111111111111100000000011
        11110000000N0000000002000000000000000000000002000000000011
       111100000000000000000111111111111111111111111100000000000011
      111100000000000000000001111                1100000000000000011
     11112000000000000000000021111              112000000000000000211
    1111111111111111111111111111111             111111111111111111111
   111111111111111111111111111111111
