
SO ./texture/blue.xpm
R 2000 200
NO ./texture/brick.xpm
S ./texture/barrel.xpm
F 220,100,0
EA ./texture/wood.xpm
C 225,30,0
WE ./texture/grey.xpm
                  111
                 10001
                1002001
               111101111
              11110001111
             1111000001111
            111100000001111
           11110000000001111
          1111000000000001111
         111100000000000001111
        11110000000N00000001111
    1111111111111111111111111111111

